

A = NEWLINE 
B = COMMENT
C = HEADER
D = NAMESPACE_STD
E = TOTALQUOTE
F = NUMBER
G = CASE
H = OTHER_OPERATOR
I = ASSIGN_OPERATOR
J = BITWISE_OPERATOR
K = RELATIONAL_OPERATOR
L = ARITHMETIC_OPERATOR
M = APPLY
N = IF
O = DATATYPE
P = SEMICOLON
Q = COMMA
R = L_CURLY_BRACE
S = R_CURLY_BRACE
T = L_SQUARE_BRACKET
U = R_SQUARE_BRACKET
V = L_PARENTHESIS
W = R_PARENTHESIS
X = ID
Y = LOOP
Z = SWITCH
a = ELSE
b = BREAK
c = CONTINUE
d = RETURN
e = GOTO
f = CATCH
g = THROW
h = SYNCHRONIZED
i = CLASS
j = TYPEDEF
k = KEYWORD



